111111111
10CEP0001
11111111