1111111111111
10010000000C1
1000011111001
100011E0C0CP1
1111111111111